R 901 800
NO ./textures/other_choices/gloomy_ft.xpm
SO ./textures/rock3.xpm
WE ./textures/tile2.xpm
EA ./textures/other_choices/orange.xpm

S ./textures/sprite.xpm

F 1,1,1
C 137,37,37

        111     1111
 11111111011111110001
 110000000100000000011
111000000002000000111
100001111111110000011
111011       12000011
1N2001111111110200011
100200000000010020011
100021111111110002011
100001       10000011
110001111111110000011
111000000020000020011
111111000000000000001
111111111111111111111
