R 900 800
NO ./textures/stone-3.xpm
SO ./textures/rock3.xpm
WE ./textures/tile.xpm
EA ./textures/tile2.xpm
S ./textures/sprite.xpm


F 1,20,80
C 120,106,235

1111111111111111111111111111111111111111
1000000000000000000000000000000000000001
1111000000000000000000000000000000000001
1000000000000020000000000000000000000111
1000000000000000000000000000000000000001
1000000000000000000000000000000000000111
1000000000000000000000000000000000000001
1000002000000000000000000000000000000201
1000000000000000000000000000000000000001
1000000000000000000000000000000000000001
1000000000000000000000000000000000000001
1000000000000000000000000000000000000001
1000000000000000000000000000000000000001
1000000000000000000000000000000000000201
1000000000000000000000000000000000000001
1000000000000000000000000000000000000001
1000000000000000000000000000000000000001
1200000000000000000000000000000000000001
1000000000000000000000000000000000000001
1000000000000000000000000000000000000001
1000000000000000000000000000000000000001
1000000000000000000000000000000000000001
1000000000000000001000000000000000000001
1000000000000000000000000000000000000001
100000000000000000N000000000000000000001
1000000000000000000000000000000000000001
1000000000000000000000000000000000000001
1000000000000000000000000000000000000001
1111111111111111111111111111111111111111
