R 900 800
NO ./textures/stone-3.xpm
SO ./textures/rock3.xpm
WE ./textures/tile.xpm
EA ./textures/tile2.xpm 

S ./textures/sprite.xpm

F 1,2,3
C 137,45,68


111
111
101
111111   1111  
1000011111001111
11120100000000011
  100110011100001
  10001001 100001
 110001001 100001     111
11020000011111111    11011
1100111000000011    1100011
 110110000000001    1002001
1110110011110001    1000011
1000111100100011    100011
10001000001000011   10011
110110011110000011111001
110000011110111011111001111
1011100100001 1000000000001
101 10N010001 1000000000001
101110000011111000111100111
1100000000000011111  1001
110110000000001      1001
111111111111111      1001
              11111111001111111111
              10000000000000000001
              10000000000000000001
              10000111111111000001
              100001       1000001
              100001       1000001
              100001       1000001
              100001       1000001
              100001       1000001
              10000111111111000001
              10000000000000000001
              10000000000000000001
              11111111111111111111
