R 1980 1020
NO ./textures/assets_textures_bookshelf.xpm
SO ./textures/assets_textures_bricks.xpm
WE ./textures/assets_textures_chiseled_red_sandstone.xpm
EA ./textures/assets_textures_chiseled_sandstone.xpm

S ./textures/assets_textures_jean2.xpm

F 220,100,0
C 135,206,235

1111111111111111111111111111111111111111
1000000000000000000000000000000001100001
1000000000000000000000000000000001100001
1000011111111000000110000000000000000001
1000011000011000000000000000000001100001
1000111000000001100000000000000000000001
1011111000000001100000000000011000011111
1011111100000001100000110000011000000011
1000000000111111111000000000011110000001
1111111100000011111000000000001110000001
1111111100111110000001100000000111111111
10000000001   10001111100000000110000001
10000111111   11111111100000000110000001
10011111111   11111100000000000000011111
1000000000111111100000000000000000000001
1000000000000001100000000000110000000001
1000000000000001111100000000110000000001
1000000000000000000E00000000000000000201
1011111111111110000000000000000000000001
1000000000000001000111000000000000000001
1111110000000000100100000000011111000001
100001001000000001010000000001   1000001
100001001000000000110000000001   1000001
1100011110010011111100000000011111000001
1110000000010010000010000000000000000001
1111000000010000111000000000000000000001
1111111111111111111111111111111111111111
